+-+-+-+-+-+-+-+-+
|               |
+   +-+       + +
|A            | |
+-+ + +-+-+ + + +
|   |       | |V|
+ + +-+-+   +-+ +
| |     |   | | |
+ +     + +-+ + +
| |     |P   T  |
+ +-+   +-+   +-+
|       |       |
+       +       +
|       |       |
+       +       +
|H              |
+-+-+-+-+-+-+-+-+
