+-+-+-+-+-+-+-+-+-+-+
|     |       |     |
+     + +-+ +-+ +-+-+
|           | |   | |
+ +-+   +-+ + +   + +
|         |       | |
+-+-+ +   +-+   + + +
| |   |         |   |
+ + + +     +-+ +   +
|   |       |   |T  |
+   +-+-+-+ +-+ +-+ +
|     |        A    |
+-+ +-+ + +       +-+
|    P  | |    V    |
+     + + +         +
|     |             |
+ +   + +-+   +-+   +
| |   |   |     |H  |
+ +   +   +-+   +-+-+
| |               | |
+-+-+-+-+-+-+-+-+-+-+
